xlt | application/vnd.ms-excel
xlw | application/vnd.ms-excel
ksp | application/vnd.kde.kspread
dfac | application/vnd.dreamfactory
atomsvc | application/atomsvc+xml
ei6 | application/vnd.pg.osasli
emma | application/emma+xml
hpid | application/vnd.hp-hpid
cct | application/x-director
xml | application/xml
tei | application/tei+xml
mxf | application/mxf
pict | image/pict
ram | audio/x-pn-realaudio
mxl | application/vnd.recordare.musicxml
vis | application/vnd.visionary
rar | application/x-rar-compressed
viv | video/vnd.vivo
cdf | application/x-cdf
ipk | application/vnd.shana.informed.package
ras | image/x-cmu-raster
tex | application/x-tex
ktr | application/vnd.kahootz
mxs | application/vnd.triscape.mxs
mxu | video/vnd.mpegurl
mjp2 | video/mj2
ktx | image/ktx
ktz | application/vnd.kahootz
cdx | chemical/x-cdx
tfi | application/thraud+xml
cdy | application/vnd.cinderella
tfm | application/x-tex-tfm
xltx | application/vnd.openxmlformats-officedocument.spreadsheetml.template
aac | audio/x-aac
aab | application/x-authorware-bin
ahead | application/vnd.ahead.space
gml | application/gml+xml
aam | application/x-authorware-map
x3db | model/x3d+binary
tga | image/x-tga
cer | application/pkix-cert
aas | application/x-authorware-seg
gmx | application/vnd.gmx
xltm | application/vnd.ms-excel.template.macroenabled.12
xop | application/xop+xml
jpeg | image/jpeg
Z | application/x-compress
xlsx | application/vnd.openxmlformats-officedocument.spreadsheetml.sheet
c | text/x-c
irm | application/vnd.ibm.rights-management
f | text/x-fortran
irp | application/vnd.irepository.package+xml
h | text/x-c
p | text/x-pascal
xpi | application/x-xpinstall
cfs | application/x-cfs-compressed
abs | audio/x-mpeg
s | text/x-asm
t | text/troff
xpm | image/x-xpixmap
rdf | application/rdf+xml
xpl | application/xproc+xml
xlsm | application/vnd.ms-excel.sheet.macroenabled.12
abw | application/x-abiword
kwd | application/vnd.kde.kword
xps | application/vnd.ms-xpsdocument
z | application/x-compress
xlsb | application/vnd.ms-excel.sheet.binary.macroenabled.12
xpr | application/vnd.is-xpr
xpw | application/vnd.intercon.formnet
acc | application/vnd.americandynamics.acc
xpx | application/vnd.intercon.formnet
ace | application/x-ace-compressed
iso | application/x-iso9660-image
jpgv | video/jpeg
cgm | image/cgm
kwt | application/vnd.kde.kword
rdz | application/vnd.data-vision.rdz
potm | application/vnd.ms-powerpoint.template.macroenabled.12
deploy | application/octet-stream
tif | image/tiff
acu | application/vnd.acucobol
pskcxml | application/pskc+xml
sldm | application/vnd.ms-powerpoint.slide.macroenabled.12
sldx | application/vnd.openxmlformats-officedocument.presentationml.slide
rep | application/vnd.businessobjects
elc | application/octet-stream
jpgm | video/jpm
gph | application/vnd.flographit
i2g | application/vnd.intergeo
res | application/x-dtbresource+xml
xbap | application/x-ms-xbap
pas | text/x-pascal
itp | application/vnd.shana.informed.formtemplate
x3dz | model/x3d+xml
paw | application/vnd.pawaafile
chm | application/vnd.ms-htmlhelp
adp | audio/adpcm
list | text/plain
gramps | application/x-gramps-xml
gpx | application/gpx+xml
uris | text/uri-list
pbd | application/vnd.powerbuilder6
pbm | image/x-portable-bitmap
x3dv | model/x3d+vrml
gqf | application/vnd.grafeq
emf | application/x-msmetafile
cif | chemical/x-cif
cii | application/vnd.anser-web-certificate-issue-initiation
eml | message/rfc822
pcurl | application/vnd.curl.pcurl
cil | application/vnd.ms-artgalry
gqs | application/vnd.grafeq
vob | video/x-ms-vob
rgb | image/x-rgb
aep | application/vnd.audiograph
xsl | application/xml
pcf | application/x-font-pcf
urls | text/uri-list
emz | application/x-msmetafile
xsm | application/vnd.syncml+xml
sv4crc | application/x-sv4crc
x32 | application/x-authorware-bin
pcl | application/vnd.hp-pcl
vor | application/vnd.stardivision.writer
gre | application/vnd.geometry-explorer
vox | application/x-authorware-bin
pct | image/pict
mseq | application/vnd.mseq
ivp | application/vnd.immervision-ivp
pcx | image/x-pcx
afm | application/x-font-type1
ivu | application/vnd.immervision-ivu
afp | application/vnd.ibm.modcap
grv | application/vnd.groove-injector
pdb | application/vnd.palm
pdf | application/pdf
potx | application/vnd.openxmlformats-officedocument.presentationml.template
gsf | application/x-font-ghostscript
ngdat | application/vnd.nokia.n-gage.data
eol | audio/vnd.digital-winds
movie | video/x-sgi-movie
x3d | model/x3d+xml
eot | application/vnd.ms-fontobject
rif | application/reginfo+xml
xul | application/vnd.mozilla.xul+xml
uvvz | application/vnd.dece.zip
uvvx | application/vnd.dece.unspecified
uvvu | video/vnd.uvvu.mp4
tmo | application/vnd.tmobile-livetv
uvvv | video/vnd.dece.video
rip | audio/vnd.rip
cla | application/vnd.claymore
ris | application/x-research-info-systems
gtm | application/vnd.groove-tool-message
uvvi | image/vnd.dece.graphic
list3820 | application/vnd.ibm.modcap
uvvg | image/vnd.dece.graphic
uvvh | video/vnd.dece.hd
clp | application/x-msclip
uvvf | application/vnd.dece.data
uvvs | video/vnd.dece.sd
eps | application/postscript
uvvt | application/vnd.dece.ttml+xml
pfa | application/x-font-type1
gtw | model/vnd.gtw
g2w | application/vnd.geoplan
pfb | application/x-font-type1
uvvp | video/vnd.dece.pd
uvvm | video/vnd.dece.mobile
xvm | application/xv+xml
h261 | video/h261
install | application/x-install-instructions
pfm | application/x-font-type1
h263 | video/h263
spot | text/vnd.in3d.spot
cmc | application/vnd.cosmocaller
h264 | video/h264
uvvd | application/vnd.dece.data
uvva | audio/vnd.dece.audio
nbp | application/vnd.wolfram.player
pfr | application/font-tdpfr
aif | audio/x-aiff
dcurl | text/vnd.curl.dcurl
cml | chemical/x-cml
pfx | application/x-pkcs12
aim | application/x-aim
es3 | application/vnd.eszigno3+xml
xwd | image/x-xwindowdump
vsd | application/vnd.visio
cmp | application/vnd.yellowriver-custom-menu
vsf | application/vnd.vsf
g3w | application/vnd.geospace
air | application/vnd.adobe.air-application-installer-package+zip
ait | application/vnd.dvb.ait
cmx | image/x-cmx
odft | application/vnd.oasis.opendocument.formula-template
listafp | application/vnd.ibm.modcap
pcap | application/vnd.tcpdump.pcap
pgn | application/x-chess-pgn
vst | application/vnd.visio
fe_launch | application/vnd.denovo.fcselayout-link
pgm | image/x-portable-graymap
vss | application/vnd.visio
pgp | application/pgp-encrypted
mobi | application/x-mobipocket-ebook
vsw | application/vnd.visio
xdssc | application/dssc+xml
nitf | application/vnd.nitf
ncx | application/x-dtbncx+xml
et3 | application/vnd.eszigno3+xml
rlc | image/vnd.fujixerox.edmics-rlc
rld | application/resource-lists-diff+xml
tpl | application/vnd.groove-tool-template
esa | application/vnd.osgi.subsystem
shar | application/x-shar
vtu | model/vnd.vtu
cod | application/vnd.rim.cod
cryptonote | application/vnd.rig.cryptonote
esf | application/vnd.epson.esf
tpt | application/vnd.trid.tpt
atom | application/atom+xml
com | application/x-msdownload
mods | application/mods+xml
pic | image/pict
body | text/html
rmi | audio/midi
x3dbz | model/x3d+binary
gxf | application/gxf
rmp | audio/x-pn-realaudio-plugin
xyz | chemical/x-xyz
rms | application/vnd.jcp.javame.midlet-rms
musicxml | application/vnd.recordare.musicxml+xml
cpp | text/x-c
gxt | application/vnd.geonext
tra | application/vnd.trueapp
cpt | application/mac-compactpro
rnc | application/relax-ng-compact-syntax
etx | text/x-setext
lbe | application/vnd.llamagraphics.life-balance.exchange+xml
trm | application/x-msterminal
lbd | application/vnd.llamagraphics.life-balance.desktop
cdxml | application/vnd.chemdraw+xml
nfo | text/x-nfo
rp9 | application/vnd.cloanto.rp9
ami | application/vnd.amiga.ami
tiff | image/tiff
tsd | application/timestamped-data
roa | application/rpki-roa
pkg | application/octet-stream
pki | application/pkixcmp
eva | application/x-eva
teacher | application/vnd.smart.teacher
crd | application/x-mscardfile
tsv | text/tab-separated-values
dump | application/octet-stream
crl | application/pkix-crl
ttc | application/x-font-ttf
crt | application/x-x509-ca-cert
plc | application/vnd.mobius.plc
plb | application/vnd.3gpp.pic-bw-large
ttf | application/x-font-ttf
evy | application/x-envoy
anx | application/annodex
djvu | image/vnd.djvu
plf | application/vnd.pocketlearn
ttl | text/turtle
gtar | application/x-gtar
application | application/x-ms-application
pls | audio/x-scpls
csh | application/x-csh
jnlp | application/x-java-jnlp-file
xslt | application/xslt+xml
inkml | application/inkml+xml
csp | application/vnd.commonspace
onepkg | application/onenote
css | text/css
cst | application/x-director
csv | text/csv
xspf | application/xspf+xml
jad | text/vnd.sun.j2me.app-descriptor
mbox | application/mbox
pml | application/vnd.ctc-posml
rmvb | application/vnd.rn-realmedia-vbr
exe | application/octet-stream
java | text/x-java-source
ccxml | application/ccxml+xml
exi | application/exi
jam | application/vnd.jam
ppam | application/vnd.ms-powerpoint.addin.macroenabled.12
docm | application/vnd.ms-word.document.macroenabled.12
jar | application/java-archive
les | application/vnd.hhe.lesson-player
ez2 | application/vnd.ezpix-album
apk | application/vnd.android.package-archive
onetoc2 | application/onenote
ez3 | application/vnd.ezpix-package
ext | application/vnd.novadigm.ext
apr | application/vnd.lotus-approach
iota | application/vnd.astraea-software.iota
distz | application/octet-stream
png | image/png
ptid | application/vnd.pvi.ptid1
texinfo | application/x-texinfo
pnm | image/x-portable-anymap
pnt | image/x-macpaint
twd | application/vnd.simtech-mindmapper
rsd | application/rsd+xml
rcprofile | application/vnd.ipunplugged.rcprofile
c4d | application/vnd.clonk.c4group
arc | application/x-freearc
rss | application/rss+xml
c4f | application/vnd.clonk.c4group
pot | application/vnd.ms-powerpoint
c4g | application/vnd.clonk.c4group
c4p | application/vnd.clonk.c4group
txd | application/vnd.genomatix.tuxedo
art | image/x-jg
txf | application/vnd.mobius.txf
lha | application/x-lzh-compressed
c4u | application/vnd.clonk.c4group
ppd | application/vnd.cups-ppd
rtf | application/rtf
gram | application/srgs
ppm | image/x-portable-pixmap
docx | application/vnd.openxmlformats-officedocument.wordprocessingml.document
asc | application/pgp-signature
txt | text/plain
pps | application/vnd.ms-powerpoint
asf | video/x-ms-asf
ppt | application/vnd.ms-powerpoint
nlu | application/vnd.neurolanguage.nlu
rtx | text/richtext
asm | text/x-asm
m3u8 | application/vnd.apple.mpegurl
aso | application/vnd.accpac.simply.aso
cpio | application/x-cpio
iges | model/iges
pqa | application/vnd.palm
cww | application/prs.cww
onetoc | application/onenote
asx | video/x-ms-asf
nml | application/vnd.enliven
p10 | application/pkcs10
p12 | application/x-pkcs12
atc | application/vnd.acucorp
hal | application/vnd.hal+xml
msty | application/vnd.muvee.style
ecma | application/ecmascript
cdbcmsg | application/vnd.contact.cmsg
cxt | application/x-director
prc | application/x-mobipocket-ebook
cxx | text/x-c
pre | application/vnd.lotus-freelance
atx | application/vnd.antix.game-component
nnd | application/vnd.noblenet-directory
prf | application/pics-rules
grxml | application/srgs+xml
nns | application/vnd.noblenet-sealer
nnw | application/vnd.noblenet-web
psb | application/vnd.3gpp.pic-bw-small
psd | image/vnd.adobe.photoshop
psf | application/x-font-linux-psf
book | application/vnd.framemaker
hbci | application/vnd.hbci
avi | video/x-msvideo
wad | application/x-doom
ssdl | application/ssdl+xml
ustar | application/x-ustar
avx | video/x-rad-screenplay
tcap | application/vnd.3gpp2.tcap
hdf | application/x-hdf
wav | audio/x-wav
ufdl | application/vnd.ufdl
wax | audio/x-ms-wax
xhtml | application/xhtml+xml
setreg | application/set-registration-initiation
npx | image/vnd.net-fpx
yang | application/yang
pub | application/x-mspublisher
setpay | application/set-payment-initiation
wbs | application/vnd.criticaltools.wbs+xml
axa | audio/annodex
midi | audio/midi
pvb | application/vnd.3gpp.pic-bw-var
axv | video/annodex
wcm | application/vnd.ms-works
lnk | application/x-ms-shortcut
dssc | application/dssc+der
wdb | application/vnd.ms-works
fbs | image/vnd.fastbidsheet
nsc | application/x-conference
nsf | application/vnd.lotus-notes
wdp | image/vnd.ms-photo
log | text/plain
pwn | application/vnd.3m.post-it-notes
sdkm | application/vnd.solent.sdkm+xml
azf | application/vnd.airzip.filesecure.azf
onetmp | application/onenote
fcs | application/vnd.isac.fcs
udeb | application/x-debian-package
azs | application/vnd.airzip.filesecure.azs
azw | application/vnd.amazon.ebook
sdkd | application/vnd.solent.sdkm+xml
yin | application/yin+xml
ntf | application/vnd.nitf
lostxml | application/lost+xml
fdf | application/vnd.fdf
jlt | application/vnd.hp-jlyt
chat | application/x-chat
pya | audio/vnd.ms-playready.media.pya
p7b | application/x-pkcs7-certificates
p7c | application/pkcs7-mime
p7m | application/pkcs7-mime
daf | application/vnd.mobius.daf
dae | model/vnd.collada+xml
p7r | application/x-pkcs7-certreqresp
pyv | video/vnd.ms-playready.media.pyv
p7s | application/pkcs7-signature
fg5 | application/vnd.fujitsu.oasysgp
scurl | text/vnd.curl.scurl
clkp | application/vnd.crick.clicker.palette
lrf | application/octet-stream
wgt | application/widget
lrm | application/vnd.ms-lrm
clkk | application/vnd.crick.clicker.keyboard
dtshd | audio/vnd.dts.hd
dbk | application/docbook+xml
fh5 | image/x-freehand
dd2 | application/vnd.oma.dd2+xml
fh4 | image/x-freehand
fh7 | image/x-freehand
clkx | application/vnd.crick.clicker
clkw | application/vnd.crick.clicker.wordbank
clkt | application/vnd.crick.clicker.template
blorb | application/x-blorb
fgd | application/x-director
acutc | application/vnd.acucorp
ssml | application/ssml+xml
ecelp9600 | audio/vnd.nuera.ecelp9600
dcr | application/x-director
pclxl | application/vnd.hp-pclxl
vxml | application/voicexml+xml
saf | application/vnd.yamaha.smaf-audio
jpe | image/jpeg
ltf | application/vnd.frogans.ltf
fhc | image/x-freehand
jpg | image/jpeg
ddd | application/vnd.fujixerox.ddd
jpm | video/jpm
wmlsc | application/vnd.wap.wmlscriptc
3dml | text/vnd.in3d.3dml
hlp | application/winhlp
jsonml | application/jsonml+json
ufd | application/vnd.ufdl
deb | application/x-debian-package
smzip | application/vnd.stepmania.package
3ds | image/x-3ds
def | text/plain
fig | application/x-xfig
mime | message/rfc822
susp | application/vnd.sus-calendar
der | application/x-x509-ca-cert
bat | application/x-msdownload
scd | application/x-msschedule
nzb | application/x-nzb
sbml | application/sbml+xml
scm | application/vnd.lotus-screencam
3g2 | video/3gpp2
wks | application/vnd.ms-works
scq | application/scvp-cv-request
ac | application/pkix-attr-cert
scs | application/scvp-cv-response
bcpio | application/x-bcpio
lvp | audio/vnd.lucent.voice
ai | application/postscript
sda | application/vnd.stardivision.draw
sdd | application/vnd.stardivision.impress
sdc | application/vnd.stardivision.calc
au | audio/basic
aw | application/applixware
ecelp7470 | audio/vnd.nuera.ecelp7470
jsf | text/plain
sdp | application/sdp
dgc | application/x-dgc-compressed
lwp | application/vnd.lotus-wordpro
sdw | application/vnd.stardivision.writer
sfd-hdstx | application/vnd.hydrostatix.sof-data
wma | audio/x-ms-wma
pptm | application/vnd.ms-powerpoint.presentation.macroenabled.12
wmd | application/x-ms-wmd
ppsx | application/vnd.openxmlformats-officedocument.presentationml.slideshow
wmf | application/x-msmetafile
see | application/vnd.seemail
wsdl | application/wsdl+xml
epub | application/epub+zip
wml | text/vnd.wap.wml
bz | application/x-bzip
3gp | video/3gpp
qam | application/vnd.epson.quickanime
cc | text/x-c
dotx | application/vnd.openxmlformats-officedocument.wordprocessingml.template
lasxml | application/vnd.las.las+xml
ser | application/java-serialized-object
wmv | video/x-ms-wmv
fli | video/x-fli
wmx | video/x-ms-wmx
bdf | application/x-font-bdf
wmz | application/x-msmetafile
flo | application/vnd.micrografx.flo
bdm | application/vnd.syncml.dm+wbxml
hps | application/vnd.hp-hps
dotm | application/vnd.ms-word.template.macroenabled.12
ppsm | application/vnd.ms-powerpoint.slideshow.macroenabled.12
flw | application/vnd.kde.kivio
flv | video/x-flv
cu | application/cu-seeme
fly | text/vnd.fly
ipfix | application/ipfix
flx | text/vnd.fmi.flexstor
dib | image/bmp
dic | text/x-c
qbo | application/vnd.intu.qbo
bed | application/vnd.realvnc.bed
sfs | application/vnd.spotfire.sfs
sfv | text/x-sfv
dir | application/x-director
dp | application/vnd.osgi.dp
latex | application/x-latex
hqx | application/mac-binhex40
dis | application/vnd.mobius.dis
dv | video/x-dv
sgi | image/sgi
sgm | text/sgml
sgl | application/vnd.stardivision.writer-global
fnc | application/vnd.frogans.fnc
gnumeric | application/x-gnumeric
lzh | application/x-lzh-compressed
mk3d | video/x-matroska
oa3 | application/vnd.fujitsu.oasys3
oa2 | application/vnd.fujitsu.oasys2
wpd | application/vnd.wordperfect
g3 | image/g3fax
bh2 | application/vnd.fujitsu.oasysprs
pptx | application/vnd.openxmlformats-officedocument.presentationml.presentation
shf | application/shf+xml
djv | image/vnd.djvu
wpl | application/vnd.ms-wpl
joda | application/vnd.joost.joda-archive
ez | application/andrew-inset
mxml | application/xv+xml
wps | application/vnd.ms-works
frame | application/vnd.framemaker
ulx | application/x-glulx
btif | image/prs.btif
ulw | audio/basic
fh | image/x-freehand
fm | application/vnd.framemaker
for | text/x-fortran
smil | application/smil+xml
wqd | application/vnd.wqd
jspf | text/plain
sid | image/x-mrsid-image
sig | application/pgp-signature
umj | application/vnd.umajin
omdoc | application/omdoc+xml
htc | text/x-component
sil | audio/silk
json | application/json
sis | application/vnd.symbian.install
class | application/java
sit | application/x-stuffit
htm | text/html
meta4 | application/metalink4+xml
oas | application/vnd.fujitsu.oasys
dll | application/x-msdownload
mrcx | application/marcxml+xml
fpx | image/vnd.fpx
gv | text/vnd.graphviz
wri | application/x-mswrite
obd | application/x-msbinder
wrl | model/vrml
gz | application/x-gzip
obj | application/x-tgif
dmg | application/x-apple-diskimage
hh | text/x-c
qfx | application/vnd.intu.qfx
bin | application/octet-stream
dmp | application/vnd.tcpdump.pcap
dms | application/octet-stream
portpkg | application/vnd.macports.portpkg
skd | application/vnd.koan
mads | application/mads+xml
skm | application/vnd.koan
texi | application/x-texinfo
dna | application/vnd.dna
hvd | application/vnd.yamaha.hv-dic
skp | application/vnd.koan
text | text/plain
skt | application/vnd.koan
unityweb | application/vnd.unity
hvp | application/vnd.yamaha.hv-voice
hvs | application/vnd.yamaha.hv-script
wtb | application/vnd.webturbo
in | text/plain
xvml | application/xv+xml
torrent | application/x-bittorrent
mathml | application/mathml+xml
rpst | application/vnd.nokia.radio-preset
rpss | application/vnd.nokia.radio-presets
odb | application/vnd.oasis.opendocument.database
oda | application/oda
odc | application/vnd.oasis.opendocument.chart
odf | application/vnd.oasis.opendocument.formula
odg | application/vnd.oasis.opendocument.graphics
odi | application/vnd.oasis.opendocument.image
fsc | application/vnd.fsc.weblaunch
ecelp4800 | audio/vnd.nuera.ecelp4800
doc | application/msword
odm | application/vnd.oasis.opendocument.text-master
odp | application/vnd.oasis.opendocument.presentation
slt | application/vnd.epson.salt
odt | application/vnd.oasis.opendocument.text
ods | application/vnd.oasis.opendocument.spreadsheet
fst | image/vnd.fst
dot | application/msword
mpega | audio/x-mpeg
chrt | application/vnd.kde.kchart
js | application/javascript
w3d | application/x-director
smf | application/vnd.stardivision.math
mac | image/x-macpaint
smi | application/smil+xml
efif | application/vnd.picsel
mag | application/vnd.ecowin.chart
ftc | application/vnd.fluxtime.clip
blb | application/x-blorb
dpg | application/vnd.dpgraph
fti | application/vnd.anser-web-funds-transfer-initiation
mc1 | application/vnd.medcalcdata
xenc | application/xenc+xml
man | text/troff
smv | video/x-smv
mar | application/octet-stream
snd | audio/basic
teicorpus | application/tei+xml
xhvml | application/xv+xml
snf | application/x-font-snf
vrml | model/vrml
uri | text/uri-list
mbk | application/vnd.mobius.mbk
wvx | video/x-ms-wvx
bmi | application/vnd.bmi
bmp | image/bmp
n3 | text/n3
oga | audio/ogg
wspolicy | application/wspolicy+xml
dist | application/octet-stream
mpga | audio/mpeg
ogg | audio/ogg
zirz | application/vnd.zul
mcd | application/vnd.mcd
uoml | application/vnd.uoml+xml
dra | audio/vnd.dra
ma | application/mathematica
mb | application/mathematica
u32 | application/x-authorware-bin
me | text/troff
oxps | application/oxps
wbmp | image/vnd.wap.wbmp
ogv | video/ogg
ogx | application/ogg
mpg4 | video/mp4
fvt | video/vnd.fvt
ms | text/troff
spc | application/x-pkcs7-certificates
spf | application/vnd.yamaha.smaf-phrase
f4v | video/x-f4v
mdb | application/x-msaccess
spl | application/x-futuresplash
woff | application/x-font-woff
spp | application/scvp-vp-response
mdi | image/vnd.ms-modi
nb | application/mathematica
dsc | text/prs.lines.tag
nc | application/x-netcdf
spq | application/scvp-vp-request
mpeg | video/mpeg
spx | audio/ogg
utz | application/vnd.uiq.theme
f77 | text/x-fortran
p8 | application/pkcs8
box | application/vnd.previewsystems.box
boz | application/x-bzip2
sql | application/x-sql
dtb | application/x-dtbook+xml
dtd | application/xml-dtd
bpk | application/octet-stream
kar | audio/midi
mesh | model/mesh
fxp | application/vnd.adobe.fxp
uva | audio/vnd.dece.audio
dts | audio/vnd.dts
uvd | application/vnd.dece.data
uvf | application/vnd.dece.data
src | application/x-wais-source
uvh | video/vnd.dece.hd
uvg | image/vnd.dece.graphic
uvi | image/vnd.dece.graphic
uvm | video/vnd.dece.mobile
uvp | video/vnd.dece.pd
uvt | application/vnd.dece.ttml+xml
uvs | video/vnd.dece.sd
srt | application/x-subrip
uvv | video/vnd.dece.video
mfm | application/vnd.mfmp
uvu | video/vnd.uvvu.mp4
uvx | application/vnd.dece.unspecified
sru | application/sru+xml
srx | application/sparql-results+xml
uvz | application/vnd.dece.zip
mft | application/rpki-manifest
f90 | text/x-fortran
curl | text/vnd.curl
ps | application/postscript
sse | application/vnd.kodak-descriptor
ssf | application/vnd.epson.ssf
mpkg | application/vnd.apple.installer+xml
dvb | video/vnd.dvb.file
dvi | application/x-dvi
mgp | application/vnd.osgeo.mapguide.package
xlam | application/vnd.ms-excel.addin.macroenabled.12
fzs | application/vnd.fuzzysheet
csml | chemical/x-csml
mgz | application/vnd.proteus.magazine
fcdt | application/vnd.adobe.formscentral.fcdt
std | application/vnd.sun.xml.draw.template
qt | video/quicktime
stc | application/vnd.sun.xml.calc.template
mets | application/mets+xml
stf | application/vnd.wt.stf
sti | application/vnd.sun.xml.impress.template
stl | application/vnd.ms-pki.stl
stk | application/hyperstudio
vcard | text/vcard
ra | audio/x-pn-realaudio
str | application/vnd.pg.format
123 | application/vnd.lotus-1-2-3
dwf | model/vnd.dwf
zaz | application/vnd.zzazz.deck+xml
mj2 | video/mj2
dwg | image/vnd.dwg
qps | application/vnd.publishare-delta-tree
mcurl | text/vnd.curl.mcurl
stw | application/vnd.sun.xml.writer.template
rl | application/resource-lists+xml
rm | application/vnd.rn-realmedia
rq | application/sparql-query
t3 | application/x-t3vm-image
rs | application/rls-services+xml
sub | text/vnd.dvb.subtitle
cmdf | chemical/x-cmdf
seed | application/vnd.fdsn.seed
karbon | application/vnd.kde.karbon
mie | application/x-mie
mid | audio/midi
mif | application/x-mif
s3m | audio/s3m
metalink | application/metalink+xml
sc | application/vnd.ibm.secure-container
sus | application/vnd.sus-calendar
dxf | image/vnd.dxf
sh | application/x-sh
sm | application/vnd.stepmania.stepchart
so | application/octet-stream
dxp | application/vnd.spotfire.dxp
dxr | application/x-director
svd | application/vnd.svd
st | application/vnd.sailingtracker.track
svc | application/vnd.dvb.service
twds | application/vnd.simtech-mindmapper
svg | image/svg+xml
maker | application/vnd.framemaker
mseed | application/vnd.fdsn.mseed
silo | model/mesh
xaml | application/xaml+xml
kfo | application/vnd.kde.kformula
link66 | application/vnd.route66.link66+xml
swa | application/x-director
fxpl | application/vnd.adobe.fxp
tr | text/troff
mka | audio/x-matroska
swf | application/x-shockwave-flash
swi | application/vnd.aristanetworks.swi
icc | application/vnd.iccprofile
ice | x-conference/x-cooltalk
c11amz | application/vnd.cluetrust.cartomobile-config-pkg
icm | application/vnd.iccprofile
ico | image/x-icon
mks | video/x-matroska
ics | text/calendar
mkv | video/x-matroska
sxd | application/vnd.sun.xml.draw
sxc | application/vnd.sun.xml.calc
svgz | image/svg+xml
uu | text/x-uuencode
sxg | application/vnd.sun.xml.writer.global
opf | application/oebps-package+xml
sxi | application/vnd.sun.xml.impress
xap | application/x-silverlight-app
qti | image/x-quicktime
xar | application/vnd.xara
sxm | application/vnd.sun.xml.math
c11amc | application/vnd.cluetrust.cartomobile-config
mlp | application/vnd.dolby.mlp
sxw | application/vnd.sun.xml.writer
qtif | image/x-quicktime
xbd | application/vnd.fujixerox.docuworks.binder
kia | application/vnd.kidspiration
xbm | image/x-xbitmap
aiff | audio/x-aiff
mmd | application/vnd.chipnuts.karaoke-mmd
sgml | text/sgml
mmf | application/vnd.smaf
aifc | audio/x-aiff
gac | application/vnd.groove-account
ief | image/ief
wg | application/vnd.pmi.widget
gam | application/x-tads
mmr | image/vnd.fujixerox.edmics-mmr
wm | video/x-ms-wm
bz2 | application/x-bzip2
davmount | application/davmount+xml
ifb | text/calendar
org | application/vnd.lotus-organizer
mng | video/x-mng
wmls | text/vnd.wap.wmlscript
dataless | application/vnd.fdsn.seed
mp2 | audio/mpeg
mp1 | audio/mpeg
mp4 | video/mp4
ifm | application/vnd.shana.informed.formdata
mp3 | audio/mpeg
xm | audio/xm
gbr | application/rpki-ghostbusters
xo | application/vnd.olpc-sugar
z1 | application/x-zmachine
z2 | application/x-zmachine
mny | application/x-msmoney
z3 | application/x-zmachine
wmlc | application/vnd.wap.wmlc
z4 | application/x-zmachine
xdf | application/xcap-diff+xml
z5 | application/x-zmachine
z6 | application/x-zmachine
z7 | application/x-zmachine
z8 | application/x-zmachine
qwd | application/vnd.quark.quarkxpress
xdm | application/vnd.syncml.dm+xml
xz | application/x-xz
osf | application/vnd.yamaha.openscoreformat
gca | application/x-gca-compressed
xdp | application/vnd.adobe.xdp+xml
conf | text/plain
xdw | application/vnd.fujixerox.docuworks
igm | application/vnd.insors.igm
sisx | application/vnd.symbian.install
igl | application/vnd.igloader
qwt | application/vnd.quark.quarkxpress
mp21 | application/mp21
igs | model/iges
mov | video/quicktime
kpxx | application/vnd.ds-keypoint
qxb | application/vnd.quark.quarkxpress
igx | application/vnd.micrografx.igx
qxd | application/vnd.quark.quarkxpress
mpa | audio/mpeg
otc | application/vnd.oasis.opendocument.chart-template
otf | application/x-font-otf
zip | application/zip
mpc | application/vnd.mophun.certificate
oth | application/vnd.oasis.opendocument.text-web
zir | application/vnd.zul
7z | application/x-7z-compressed
mpe | video/mpeg
otg | application/vnd.oasis.opendocument.graphics-template
qxl | application/vnd.quark.quarkxpress
xer | application/patch-ops-error+xml
mpg | video/mpeg
oti | application/vnd.oasis.opendocument.image-template
thmx | application/vnd.ms-officetheme
mpn | application/vnd.mophun.application
otp | application/vnd.oasis.opendocument.presentation-template
mpm | application/vnd.blueice.multipass
mpp | application/vnd.ms-project
qxt | application/vnd.quark.quarkxpress
gdl | model/vnd.gdl
ott | application/vnd.oasis.opendocument.text-template
ots | application/vnd.oasis.opendocument.spreadsheet-template
mpt | application/vnd.ms-project
osfpvg | application/vnd.yamaha.openscoreformat.osfpvg+xml
mpy | application/vnd.ibm.minipay
taglet | application/vnd.mynfc
x3dvz | model/x3d+vrml
flac | audio/flac
iif | application/vnd.shana.informed.interchange
kml | application/vnd.google-earth.kml+xml
m13 | application/x-msmediaview
geo | application/vnd.dynageo
dart | application/vnd.dart
m14 | application/x-msmediaview
sema | application/vnd.sema
mqy | application/vnd.mobius.mqy
vcd | application/x-cdlink
htke | application/vnd.kenameaapp
vcf | text/x-vcard
kmz | application/vnd.google-earth.kmz
gex | application/vnd.geometry-explorer
vcg | application/vnd.groove-vcard
semd | application/vnd.semd
semf | application/vnd.semf
mrc | application/marc
mp2a | audio/mpeg
kne | application/vnd.kinar
vcs | text/x-vcalendar
n-gage | application/vnd.nokia.n-gage.symbian.install
vcx | application/vnd.vcx
knp | application/vnd.kinar
mpv2 | video/mpeg2
m21 | application/mp21
sitx | application/x-stuffitx
opml | text/x-opml
msf | application/vnd.epson.msf
msi | application/x-msdownload
ggb | application/vnd.geogebra.file
msh | model/mesh
xht | application/xhtml+xml
msl | application/vnd.mobius.msl
roff | text/troff
kon | application/vnd.kde.kontour
mp4s | application/mp4
m1v | video/mpeg
xif | image/vnd.xiff
ggt | application/vnd.geogebra.tool
mp4v | video/mp4
atomcat | application/atomcat+xml
html | text/html
zmm | application/vnd.handheld-entertainment+xml
m2a | audio/mpeg
mp4a | audio/mp4
tao | application/vnd.tao.intent-module-archive
ghf | application/vnd.groove-help
tar | application/x-tar
oxt | application/vnd.openofficeorg.extension
webp | image/webp
kpr | application/vnd.kde.kpresenter
mts | model/vnd.mts
kpt | application/vnd.kde.kpresenter
webm | video/webm
edm | application/vnd.novadigm.edm
m2v | video/mpeg
edx | application/vnd.novadigm.edx
cb7 | application/x-cbr
m3a | audio/mpeg
weba | audio/webm
pkipath | application/pkix-pkipath
cab | application/vnd.ms-cab-compressed
gif | image/gif
xfdf | application/vnd.adobe.xfdf
caf | audio/x-caf
appcache | text/cache-manifest
gim | application/vnd.groove-identity-message
mus | application/vnd.musician
imp | application/vnd.accpac.simply.imp
ims | application/vnd.ms-ims
m3u | audio/x-mpegurl
xfdl | application/vnd.xfdl
cap | application/vnd.tcpdump.pcap
car | application/vnd.curl.car
cat | application/vnd.ms-pki.seccat
sv4cpio | application/x-sv4cpio
wbxml | application/vnd.wap.wbxml
mvb | application/x-msmediaview
m4b | audio/mp4
m4a | audio/mp4
tcl | application/x-tcl
hpgl | application/vnd.hp-hpgl
cba | application/x-cbr
cdmic | application/cdmi-container
cdmid | application/cdmi-domain
cdmia | application/cdmi-capability
oprc | application/vnd.palm
ink | application/inkml+xml
mscml | application/mediaservercontrol+xml
m4r | audio/mp4
xla | application/vnd.ms-excel
jisp | application/vnd.jisp
m4v | video/mp4
xlc | application/vnd.ms-excel
m4u | video/vnd.mpegurl
cdmio | application/cdmi-object
cbr | application/x-cbr
xlf | application/x-xliff+xml
cbt | application/x-cbr
cdmiq | application/cdmi-queue
xlm | application/vnd.ms-excel
cbz | application/x-cbr
cdkey | application/vnd.mediastation.cdkey
mwf | application/vnd.mfer
xls | application/vnd.ms-excel